........................#############........................
........................#...........#........................
........................#...........#........................
........................#...........#........................
........................#...#############....................
........................#...#.......#...#....................
........................#...#.......#...#....................
........................#...#.......#...#....................
........................#...#.......#######..................
........................#...#...........#.#..................
......................#######...........#######..............
......................#.#.................#...#..............
................#########.................#...#..............
................#.....#...................#...#..............
................#.....#...................#...#..............
................#.....#...................#...#..............
................#.....#...................#######............
................#.....#.......................#.#............
................#.....#.......................#############..
................#.....#.........................#.........#..
................#.....#.........................#.........#..
................#.....#.........................#.........#..
..............#########.........................#.........#..
..............#.#...............................#.........#..
........#########...............................############^
........#.....#...........................................#..
........#.....#...........................................#..
........#.....#...........................................#..
........#.....#...........................................#..
........#.....#...........................................#..
#########.....#...................................#########..
#.............#...................................#..........
#.............#...................................#..........
#.............#...................................#..........
#.............#############.......................#..........
#.........................#.......................#..........
#############.............#.......................#..........
............#.............#.......................#..........
............#.............#.......................#..........
............#.............#.......................#..........
............#.............#.......................#..........
............#.............#.......................#..........
............#.............#.................#######..........
............#...............................#................
............#######.........................#................
..................#.........................#................
..................#.........................#................
..................#.........................#................
..................#.................#########................
..................#.................#........................
..................#.................#........................
..................#.................#........................
..................#######...........#........................
........................#...........#........................
........................#...........#........................
........................#...........#........................
........................#...........#........................
........................#...........#........................
........................#...........#........................
........................#...........#........................
........................#############........................